$	ドル
$	米ドル
$	米ドル
£	英国ポンド
€	ユーロ
₩	勝った
nzd	ニュージーランドドル
rs	ルピー
chf	スイスフラン
dkk	デンマーククローネ
fim	フィンランドのマルッカ
aed	アラブ首長国連邦ディルハム
¥	円
czk	チェココルナ
mro	モーリタニアのウギア
pkr	パキスタン・ルピー
crc	コスタリカのコロン
hk$	香港ドル
npr	ネパールルピー
awg	アルバフロリン
nok	ノルウェークローネ
tzs	タンザニアシリング
sek	スウェーデンクローナ
cyp	キプロスポンド
r	本物
sar	サウジアラビアリヤル
cve	カーボベルデ エスクード
rsd	セルビアディナール
dm	ドイツマーク
shp	セントヘレナ・ポンド
php	フィリピンペソ
cad	カナダドル
ssp	南スーダンポンド
scr	セーシェル・ルピー
mvr	モルディブ・ルフィア