e.g.	例えば
dr.	博士
mr.	紳士
mrs.	逃す
st.	saint
7-eleven	セブンイレブン
es3	e s 三
s&p	s and p
ASAP	a s a p
AT&T	a t and t
LLP	l l p
b to b	B2B
b to c	B2C
c to c	C2C
c to b	C2B
億	億
兆	兆
ps三	ps3
ps四	ps4
ATM	エーティーエム
十数か二十	十数か二十
幸四郎	幸四郎
白雪姫と七人のこびと	白雪姫と七人のこびと
AKB48	AKB48
七夕	七夕
千夜一夜	千夜一夜
三百六十行	三百六十行
十五の月	十五の月
冷凍三足	冷凍三足
三十年河東	三十年河東
三十年河西	三十年河西
千年後	千年後
五月天	五月天
安倍晋三	安倍晋三
小泉純一郎	小泉純一郎
山本五十六	山本五十六
裕一	裕一
優一	優一
太一	太一
雄一	雄一
泰一	泰一
金田一	金田一
三宅健	三宅健
国分太一	国分太一
東郷平八郎	東郷平八郎
石田三成	石田三成
山内一豊	山内一豊
渋沢栄一	渋沢栄一
土方歳井	土方歳井
二宮金次郎	二宮金次郎
小津安二郎	小津安二郎
本田宗一郎	本田宗一郎
佐藤一郎	佐藤一郎
一郎	一郎
二郎	二郎
三郎	三郎
四郎	四郎
五郎	五郎
六郎	六郎
七郎	七郎
一の上	一の上
一の倉	一の倉
一の口	一の口
一の坪	一の坪
一の宮	一の宮
一の渡	一の渡
一の瀬	一の瀬
一の谷	一の谷
一の関	一の関
一ツ井	一ツ井
一ツ子	一ツ子
一ツ家	一ツ家
一ツ屋	一ツ屋
一ツ山	一ツ山
一ツ木	一ツ木
一ツ本松	一ツ本松
一ツ松	一ツ松
一ツ柳	一ツ柳
一ツ森	一ツ森
一ツ橋	一ツ橋
一ツ氏	一ツ氏
一ツ渡	一ツ渡
一ツ田	一ツ田
一ツ町	一ツ町
一ツ矢	一ツ矢
一ツ石	一ツ石
一ツ谷	一ツ谷
一ノ世	一ノ世
一ノ井	一ノ井
一ノ倉	一ノ倉
一ノ勢	一ノ勢
一ノ原	一ノ原
一ノ口	一ノ口
一ノ名	一ノ名
一ノ坪	一ノ坪
一ノ子	一ノ子
一ノ字	一ノ字
一ノ宮	一ノ宮
一ノ尾	一ノ尾
一ノ山	一ノ山
一ノ川	一ノ川
一ノ戸	一ノ戸
一ノ木	一ノ木
一ノ木戸	一ノ木戸
一ノ本	一ノ本
一ノ枝	一ノ枝
一ノ橋	一ノ橋
一ノ沢	一ノ沢
一ノ清	一ノ清
一ノ渡	一ノ渡
一ノ澤	一ノ澤
一ノ瀬	一ノ瀬
一ノ田	一ノ田
一ノ矢	一ノ矢
一ノ穂	一ノ穂
一ノ谷	一ノ谷
一ノ間	一ノ間
一ノ関	一ノ関
一丁田	一丁田
一丁畑	一丁畑
一万田	一万田
一上	一上
一下	一下
一与	一与
一世	一世
一丸	一丸
一乃瀬	一乃瀬
一久	一久
一久保	一久保
一之上	一之上
一之宮	一之宮
一之木	一之木
一之森	一之森
一之沢	一之沢
一之澤	一之澤
一之瀬	一之瀬
一之谷	一之谷
一乗	一乗
一乘	一乘
一事	一事
一井	一井
一仏	一仏
一伊達	一伊達
一住連	一住連
一佛	一佛
一作	一作
一倉	一倉
一元	一元
一光	一光
一児島	一児島
一兜	一兜
一入	一入
一内	一内
一円	一円
一冨	一冨
一刀	一刀
一分片	一分片
一刈	一刈
一刎	一刎
一前	一前
一力	一力
一勢	一勢
一北	一北
一十林	一十林
一原	一原
一又	一又
一双	一双
一反田	一反田
一口	一口
一司	一司
一吉	一吉
一后	一后
一向	一向
一味	一味
一和	一和
一和多	一和多
一和田	一和田
一噌	一噌
一圓	一圓
一地	一地
一坂	一坂
一坊	一坊
一坊寺	一坊寺
一坪	一坪
一垣	一垣
一城	一城
一堂	一堂
一場	一場
一塚	一塚
一塲	一塲
一増	一増
一天満谷	一天満谷
一好	一好
一宅	一宅
一宇	一宇
一守	一守
一安	一安
一定	一定
一宝	一宝
一宮	一宮
一家	一家
一富	一富
一富士	一富士
一寳	一寳
一寶	一寶
一寸木	一寸木
一寺	一寺
一尺八寸	一尺八寸
一尾	一尾
一居	一居
一山	一山
一岐	一岐
一岡	一岡
一岩	一岩
一峯寺	一峯寺
一峰	一峰
一峰寺	一峰寺
一島	一島
一崎	一崎
一嶋	一嶋
一嶌	一嶌
一川	一川
一布	一布
一幡	一幡
一平	一平
一広	一広
一庵	一庵
一廣	一廣
一廼穂	一廼穂
一式	一式
一弛	一弛
一徳	一徳
一心	一心
一志	一志
一恩	一恩
一戸	一戸
一振	一振
一政	一政
一文字	一文字
一斗	一斗
一新	一新
一方井	一方井
一方隅	一方隅
一明	一明
一星	一星
一最	一最
一期	一期
一期崎	一期崎
一木	一木
一木戸	一木戸
一本	一本
一本島	一本島
一本嶋	一本嶋
一本木	一本木
一本杉	一本杉
一本松	一本松
一本柳	一本柳
一本槍	一本槍
一本鎗	一本鎗
一杉	一杉
一村	一村
一条	一条
一来	一来
一松	一松
一林	一林
一枚田	一枚田
一枝	一枝
一柳	一柳
一柿	一柿
一栄	一栄
一桐	一桐
一桝	一桝
一條	一條
一棟	一棟
一森	一森
一植庵	一植庵
一楽	一楽
一樂	一樂
一樋	一樋
一樹	一樹
一橋	一橋
一氏	一氏
一水	一水
一永	一永
一沢	一沢
一河	一河
一泉	一泉
一津屋	一津屋
一津田	一津田
一津矢	一津矢
一津谷	一津谷
一浦	一浦
一海	一海
一渡	一渡
一湊	一湊
一溝	一溝
一滴	一滴
一澤	一澤
一瀬	一瀬
一玖	一玖
一瓢	一瓢
一田	一田
一田山	一田山
一由	一由
一甲	一甲
一町	一町
一町田	一町田
一畝	一畝
一番ケ瀬	一番ケ瀬
一番合戦	一番合戦
一番屋	一番屋
一番星	一番星
一登	一登
一百野	一百野
一盃森	一盃森
一盛	一盛
一真	一真
一矢	一矢
一石	一石
一社	一社
一神	一神
一笠	一笠
一筆	一筆
一箭	一箭
一篠	一篠
一籏	一籏
一糸	一糸
一美	一美
一羽	一羽
一老	一老
一肩	一肩
一脇	一脇
一與	一與
一興	一興
一舎	一舎
一色	一色
一色田	一色田
一芝	一芝
一華	一華
一萬田	一萬田
一葉	一葉
一薮	一薮
一藁	一藁
一藤	一藤
一藤木	一藤木
一蝶	一蝶
一見	一見
一視	一視
一角	一角
一言	一言
一谷	一谷
一貫坂	一貫坂
一貫田	一貫田
一越	一越
一路	一路
一身	一身
一軸	一軸
一迫	一迫
一道	一道
一適	一適
一邨	一邨
一郎丸	一郎丸
一郡	一郡
一部	一部
一郷	一郷
一都	一都
一里塚	一里塚
一里山	一里山
一里越	一里越
一重	一重
一野	一野
一野坪	一野坪
一野本	一野本
一野瀬	一野瀬
一野谷	一野谷
一野辺	一野辺
一野邊	一野邊
一針	一針
一釣	一釣
一鉄	一鉄
一鍬田	一鍬田
一鏡	一鏡
一鐵	一鐵
一門	一門
一間	一間
一関	一関
一關	一關
一阪	一阪
一阿	一阿
一陣	一陣
一階	一階
一霍	一霍
一青	一青
一面	一面
一願	一願
一香	一香
一馬	一馬
一駒	一駒
一高	一高
一鬼	一鬼
一鷓	一鷓
一鷹	一鷹
七々原	七々原
七々木	七々木
七々瀬	七々瀬
七ケ所	七ケ所
七ツ役	七ツ役
七ツ村	七ツ村
七ツ河	七ツ河
七ツ田	七ツ田
七ツ町	七ツ町
七ツ矢	七ツ矢
七ツ谷	七ツ谷
七丈	七丈
七世	七世
七久保	七久保
七五三	七五三
七五三掛	七五三掛
七五三木	七五三木
七五三田	七五三田
七五三野	七五三野
七井	七井
七俵	七俵
七倉	七倉
七元	七元
七分	七分
七利	七利
七加家	七加家
七十刈	七十刈
七十苅	七十苅
七原	七原
七反田	七反田
七呂	七呂
七味	七味
七坂	七坂
七堂	七堂
七塚	七塚
七夕	七夕
七字	七字
七宝	七宝
七宮	七宮
七家	七家
七寳	七寳
七尾	七尾
七尾谷	七尾谷
七山	七山
七山谷	七山谷
七岡	七岡
七島	七島
七崎	七崎
七嵐	七嵐
七嶋	七嶋
七川	七川
七帖	七帖
七度	七度
七座	七座
七役	七役
七徳	七徳
七戸	七戸
七搦	七搦
七日市	七日市
七星	七星
七木田	七木田
七本	七本
七村	七村
七条	七条
七松	七松
七林	七林
七枝	七枝
七栗	七栗
七條	七條
七森	七森
七楽	七楽
七歩	七歩
七沢	七沢
七河	七河
七波	七波
七津角	七津角
七浦	七浦
七海	七海
七滝	七滝
七澤	七澤
七瀧	七瀧
七瀬	七瀬
七瀬川	七瀬川
七瀬谷	七瀬谷
七熊	七熊
七牟礼	七牟礼
七牟禮	七牟禮
七理	七理
七田	七田
七町	七町
七目木	七目木
七石	七石
七社	七社
七種	七種
七竹	七竹
七篠	七篠
七納	七納
七絛	七絛
七良川	七良川
七良浴	七良浴
七草	七草
七草木	七草木
七蔵司	七蔵司
七藏司	七藏司
七見	七見
七角	七角
七谷	七谷
七軒	七軒
七辺	七辺
七迫	七迫
七邊	七邊
七郎丸	七郎丸
七部	七部
七里	七里
七野	七野
七釜	七釜
七釜子	七釜子
七門	七門
七間	七間
七障子	七障子
七類	七類
七高	七高
七黒	七黒
万	万
万々	万々
万ケ谷	万ケ谷
万ノ	万ノ
万丈	万丈
万上	万上
万世	万世
万両	万両
万並	万並
万中	万中
万丸	万丸
万久	万久
万久里	万久里
万亀	万亀
万亀山	万亀山
万事	万事
万井	万井
万代	万代
万代呂	万代呂
万代寺	万代寺
万仲	万仲
万佐木	万佐木
万保	万保
万俵	万俵
万倉	万倉
万元	万元
万光	万光
万公	万公
万処	万処
万出	万出
万利乃	万利乃
万前	万前
万力	万力
万力屋	万力屋
万力谷	万力谷
万十	万十
万千野	万千野
万司	万司
万合	万合
万名	万名
万善	万善
万喜	万喜
万国	万国
万国谷	万国谷
万地	万地
万城	万城
万城目	万城目
万埜	万埜
万場	万場
万塩	万塩
万壽本	万壽本
万好	万好
万子	万子
万字	万字
万宝	万宝
万実	万実
万宮	万宮
万家	万家
万實	万實
万寿	万寿
万寿本	万寿本
万尾	万尾
万屋	万屋
万山	万山
万岡	万岡
万崎	万崎
万川	万川
万平	万平
万年	万年
万年山	万年山
万幸	万幸
万広	万広
万度	万度
万庭	万庭
万廣	万廣
万徳	万徳
万慶	万慶
万戈	万戈
万成	万成
万我	万我
万戸	万戸
万所	万所
万才	万才
万方	万方
万月	万月
万木	万木
万本	万本
万束	万束
万条	万条
万来	万来
万條	万條
万森	万森
万楽	万楽
万正	万正
万歩	万歩
万歳	万歳
万殿	万殿
万水	万水
万永	万永
万江	万江
万沢	万沢
万治	万治
万波	万波
万津	万津
万洲	万洲
万浪	万浪
万浮	万浮
万澤	万澤
万濃	万濃
万瀬	万瀬
万灯	万灯
万燈	万燈
万狩	万狩
万玉	万玉
万田	万田
万直	万直
万矢	万矢
万石	万石
万砂	万砂
万福	万福
万福寺	万福寺
万立	万立
万竝	万竝
万納	万納
万納寺	万納寺
万羽	万羽
万膳	万膳
万葉	万葉
万藤	万藤
万行	万行
万袋	万袋
万見	万見
万谷	万谷
万豆	万豆
万財	万財
万賀	万賀
万越	万越
万足	万足
万辺	万辺
万辻	万辻
万造寺	万造寺
万道	万道
万邉	万邉
万邊	万邊
万部	万部
万里	万里
万里小路	万里小路
万里崎	万里崎
万里川	万里川
万重	万重
万野	万野
万金	万金
万開	万開
万関	万関
万阿弥	万阿弥
万雲	万雲
万願寺	万願寺
万𡌛	万𡌛
丈六	丈六
三々賀	三々賀
三つ石	三つ石
三の丸	三の丸
三の宮	三の宮
三の輪	三の輪
三カ崎	三カ崎
三ケ	三ケ
三ケ原	三ケ原
三ケ尻	三ケ尻
三ケ山	三ケ山
三ケ島	三ケ島
三ケ崎	三ケ崎
三ケ嶋	三ケ嶋
三ケ月	三ケ月
三ケ木	三ケ木
三ケ本	三ケ本
三ケ森	三ケ森
三ケ津	三ケ津
三ケ田	三ケ田
三ケ部	三ケ部
三ケ野	三ケ野
三ケ野原	三ケ野原
三ツ	三ツ
三ツ中	三ツ中
三ツ丸	三ツ丸
三ツ井	三ツ井
三ツ俣	三ツ俣
三ツ倉	三ツ倉
三ツ元	三ツ元
三ツ出	三ツ出
三ツ又	三ツ又
三ツ口	三ツ口
三ツ国	三ツ国
三ツ國	三ツ國
三ツ堀	三ツ堀
三ツ塚	三ツ塚
三ツ家	三ツ家
三ツ寄	三ツ寄
三ツ寺	三ツ寺
三ツ尾	三ツ尾
三ツ居	三ツ居
三ツ屋	三ツ屋
三ツ山	三ツ山
三ツ岡	三ツ岡
三ツ岩	三ツ岩
三ツ峰	三ツ峰
三ツ島	三ツ島
三ツ崎	三ツ崎
三ツ嶋	三ツ嶋
三ツ川	三ツ川
三ツ巻	三ツ巻
三ツ平	三ツ平
三ツ広	三ツ広
三ツ廣	三ツ廣
三ツ扇	三ツ扇
三ツ持	三ツ持
三ツ星	三ツ星
三ツ木	三ツ木
三ツ本	三ツ本
三ツ杉	三ツ杉
三ツ村	三ツ村
三ツ松	三ツ松
三ツ林	三ツ林
三ツ柳	三ツ柳
三ツ梨	三ツ梨
三ツ森	三ツ森
三ツ橋	三ツ橋
三ツ汐	三ツ汐
三ツ江	三ツ江
三ツ池	三ツ池
三ツ沢	三ツ沢
三ツ沼	三ツ沼
三ツ泉	三ツ泉
三ツ浜	三ツ浜
三ツ浦	三ツ浦
三ツ浪	三ツ浪
三ツ溝	三ツ溝
三ツ滝	三ツ滝
三ツ澤	三ツ澤
三ツ濱	三ツ濱
三ツ瀬	三ツ瀬
三ツ田	三ツ田
三ツ畑	三ツ畑
三ツ目	三ツ目
三ツ矢	三ツ矢
三ツ石	三ツ石
三ツ股	三ツ股
三ツ角	三ツ角
三ツ谷	三ツ谷
三ツ辻	三ツ辻
三ツ邑	三ツ邑
三ツ野	三ツ野
三ツ間	三ツ間
三ノ上	三ノ上
三ノ丸	三ノ丸
三ノ京	三ノ京
三ノ宮	三ノ宮
三ノ戸	三ノ戸
三ノ浦	三ノ浦
三ノ輪	三ノ輪
三ヵ木	三ヵ木
三丁	三丁
三丁目	三丁目
三七	三七
三丈	三丈
三上	三上
三上山	三上山
三下	三下
三与木	三与木
三世	三世
三世川	三世川
三並	三並
三中	三中
三中西	三中西
三串	三串
三丸	三丸
三乃	三乃
三久	三久
三久保	三久保
三之丸	三之丸
三之宮	三之宮
三之本	三之本
三之瀬	三之瀬
三之輪	三之輪
三乗	三乗
三乘	三乘
三九	三九
三九二	三九二
三亀	三亀
三亀山	三亀山
三二	三二
三五	三五
三井	三井
三井倉	三井倉
三井原	三井原
三井名	三井名
三井寺	三井寺
三井島	三井島
三井戸	三井戸
三井所	三井所
三井津	三井津
三井田	三井田
三京	三京
三仏	三仏
三仙	三仙
三代	三代
三代地	三代地
三代崎	三代崎
三代川	三代川
三代木	三代木
三代森	三代森
三代沢	三代沢
三代澤	三代澤
三代瀬	三代瀬
三代田	三代田
三代野	三代野
三仲	三仲
三伍	三伍
三伝	三伝
三位	三位
三位所	三位所
三住	三住
三佐	三佐
三佐々川	三佐々川
三佐保	三佐保
三佐和	三佐和
三佐尾	三佐尾
三佐崎	三佐崎
三佐川	三佐川
三佐藤	三佐藤
三余	三余
三佛	三佛
三保	三保
三保家	三保家
三保木	三保木
三保田	三保田
三保谷	三保谷
三保野	三保野
三信	三信
三俣	三俣
三俵	三俵
三倉	三倉
三個	三個
三傅	三傅
三傳	三傳
三僮	三僮
三元	三元
三先	三先
三光	三光
三光坊	三光坊
三光寺	三光寺
三光楼	三光楼
三光院	三光院
三入	三入
三八九	三八九
三八木	三八木
三八木沢	三八木沢
三八木澤	三八木澤
三共	三共
三其	三其
三具	三具
三内	三内
三冨	三冨
三冨士	三冨士
三凌	三凌
三刀	三刀
三刀屋	三刀屋
三刀谷	三刀谷
三分	三分
三分一	三分一
三分一所	三分一所
三分利	三分利
三前	三前
三力谷	三力谷
三功	三功
三加	三加
三加茂	三加茂
三勢	三勢
三包	三包
三北	三北
三十刈	三十刈
三十尾	三十尾
三十日	三十日
三十木	三十木
三十苅	三十苅
三十間	三十間
三千	三千
三千山	三千山
三千田	三千田
三升	三升
三升木	三升木
三升畑	三升畑
三升谷	三升谷
三原	三原
三原屋	三原屋
三原松	三原松
三原田	三原田
三原詰	三原詰
三原鍛治	三原鍛治
三厨	三厨
三又	三又
三友	三友
三双	三双
三反	三反
三反園	三反園
三反崎	三反崎
三反田	三反田
三反畑	三反畑
三反長	三反長
三叚崎	三叚崎
三口	三口
三古	三古
三古谷	三古谷
三可	三可
三合	三合
三合堂	三合堂
三吉	三吉
三吉矢	三吉矢
三吉谷	三吉谷
三吉野	三吉野
三名木	三名木
三名本	三名本
三名田	三名田
三吾	三吾
三味	三味
三和	三和
三和山	三和山
三和田	三和田
三品	三品
三品寺	三品寺
三善	三善
三喜	三喜
三喜田	三喜田
三喜畑	三喜畑
三嘴	三嘴
三四	三四
三国	三国
三国出	三国出
三国屋	三国屋
三国谷	三国谷
三國	三國
三國屋	三國屋
三國谷	三國谷
三園	三園
三土	三土
三土井	三土井
三土手	三土手
三在	三在
三地	三地
三地沢	三地沢
三地澤	三地澤
三坂	三坂
三坊	三坊
三坪	三坪
三垣	三垣
三城	三城
三埜	三埜
三堀	三堀
三堂	三堂
三堂地	三堂地
三堤	三堤
三場	三場
三塚	三塚
三塩	三塩
三増	三増
三墨	三墨
三壁	三壁
三声	三声
三壷	三壷
三壺	三壺
三壽	三壽
三多	三多
三多村	三多村
三多田	三多田
三多見	三多見
三夜	三夜
三大	三大
三大寺	三大寺
三太	三太
三奈戸	三奈戸
三奈木	三奈木
三好	三好
三好野	三好野
三妙	三妙
三妻	三妻
三姓	三姓
三宅	三宅
三宅川	三宅川
三宇根	三宇根
三守	三守
三安	三安
三宗	三宗
三宝	三宝
三室	三室
三室戸	三室戸
三宮	三宮
三家	三家
三家丸	三家丸
三家本	三家本
三宿	三宿
三寄	三寄
三富	三富
三富士	三富士
三寳	三寳
三寶	三寶
三寸木	三寸木
三寺	三寺
三寿	三寿
三尋木	三尋木
三小	三小
三小牛	三小牛
三小田	三小田
三尾	三尾
三尾原	三尾原
三尾川	三尾川
三尾母	三尾母
三尾谷	三尾谷
三尾野	三尾野
三居	三居
三屋	三屋
三屋田	三屋田
三山	三山
三山口	三山口
三岐	三岐
三岡	三岡
三岩	三岩
三岳	三岳
三岸	三岸
三峯	三峯
三峰	三峰
三島	三島
三島木	三島木
三崎	三崎
三崎屋	三崎屋
三嵜	三嵜
三嶋	三嶋
三嶋木	三嶋木
三嶌	三嶌
三嶽	三嶽
三川	三川
三川原	三川原
三州	三州
三差	三差
三巴	三巴
三巻	三巻
三市	三市
三師	三師
三帰	三帰
三幡	三幡
三幣	三幣
三平	三平
三年	三年
三幸	三幸
三広	三広
三府	三府
三度	三度
三廉	三廉
三廚	三廚
三廻部	三廻部
三廼	三廼
三弊	三弊
三引	三引
三弦谷	三弦谷
三張	三張
三影	三影
三待	三待
三後	三後
三徳	三徳
三徳屋	三徳屋
三志多	三志多
三志奈	三志奈
三恵	三恵
三惠	三惠
三慶	三慶
三成	三成
三戸	三戸
三戸代	三戸代
三戸口	三戸口
三戸呂	三戸呂
三戸尻	三戸尻
三戸岡	三戸岡
三戸手	三戸手
三戸森	三戸森
三戸瀬	三戸瀬
三戸田	三戸田
三戸見	三戸見
三戸谷	三戸谷
三戸辺	三戸辺
三戸邉	三戸邉
三戸部	三戸部
三房	三房
三手木	三手木
三才	三才
三才町	三才町
三扶	三扶
三技	三技
三折	三折
三掘	三掘
三摩	三摩
三改木	三改木
三政	三政
三文字	三文字
三方	三方
三日尻	三日尻
三日市	三日市
三日月	三日月
三日田	三日田
三昌	三昌
三明	三明
三星	三星
三春	三春
三時	三時
三曳	三曳
三曵	三曵
三曽田	三曽田
三曾野	三曾野
三月	三月
三月田	三月田
三朕	三朕
三朝	三朝
三木	三木
三木元	三木元
三木原	三木原
三木家	三木家
三木屋	三木屋
三木本	三木本
三木江	三木江
三木田	三木田
三木谷	三木谷
三木野	三木野
三末	三末
三本	三本
三本木	三本木
三本杉	三本杉
三本松	三本松
三本柳	三本柳
三本漆	三本漆
三本竹	三本竹
三本管	三本管
三本菅	三本菅
三杉	三杉
三村	三村
三村田	三村田
三束	三束
三条	三条
三条場	三条場
三条橋	三条橋
三条目	三条目
三条西	三条西
三条谷	三条谷
三杭	三杭
三杯	三杯
三東	三東
三松	三松
三林	三林
三枚地	三枚地
三枚堂	三枚堂
三枚山	三枚山
三枚橋	三枚橋
三枝	三枝
三枝崎	三枝崎
三枝木	三枝木
三枝松	三枝松
三枝樹	三枝樹
三枡	三枡
三柏	三柏
三染	三染
三柳	三柳
三柴	三柴
三栄	三栄
三栖	三栖
三栖本	三栖本
三栖谷	三栖谷
三栗	三栗
三栗家	三栗家
三栗屋	三栗屋
三栗谷	三栗谷
三栗野	三栗野
三根	三根
三根山	三根山
三根生	三根生
三根谷	三根谷
三桐	三桐
三桝	三桝
三桶	三桶
三條	三條
三條場	三條場
三條目	三條目
三條西	三條西
三條谷	三條谷
三梨	三梨
三棟	三棟
三森	三森
三棹	三棹
三椚	三椚
三楊	三楊
三楠	三楠
三榊	三榊
三槁	三槁
三槇	三槇
三槙	三槙
三槻	三槻
三横	三横
三横呂	三横呂
三樹	三樹
三樹元	三樹元
三橋	三橋
三次	三次
三武	三武
三武士	三武士
三歩	三歩
三歩一	三歩一
三段	三段
三段崎	三段崎
三母	三母
三比	三比
三毛	三毛
三毛門	三毛門
三水	三水
三永	三永
三永川	三永川
三江	三江
三池	三池
三池田	三池田
三沖	三沖
三沢	三沢
三河	三河
三河井	三河井
三河内	三河内
三河原	三河原
三河口	三河口
三河尻	三河尻
三河島	三河島
三河嶋	三河嶋
三河谷	三河谷
三治	三治
三沼	三沼
三波	三波
三洗	三洗
三津	三津
三津中	三津中
三津井	三津井
三津出	三津出
三津原	三津原
三津国	三津国
三津國	三津國
三津守	三津守
三津家	三津家
三津尾	三津尾
三津屋	三津屋
三津山	三津山
三津島	三津島
三津川	三津川
三津木	三津木
三津本	三津本
三津村	三津村
三津林	三津林
三津橋	三津橋
三津永	三津永
三津江	三津江
三津沢	三津沢
三津浜	三津浜
三津澤	三津澤
三津田	三津田
三津目	三津目
三津矢	三津矢
三津石	三津石
三津谷	三津谷
三津越	三津越
三津輪	三津輪
三津野	三津野
三津間	三津間
三洲	三洲
三浅	三浅
三浜	三浜
三浦	三浦
三浪	三浪
三海	三海
三淵	三淵
三添	三添
三清	三清
三渓	三渓
三渕	三渕
三渡	三渡
三渡洲	三渡洲
三満	三満
三満田	三満田
三溝	三溝
三滝	三滝
三潟	三潟
三潴	三潴
三澄	三澄
三澤	三澤
三濃川	三濃川
三濱	三濱
三瀦	三瀦
三瀧	三瀧
三瀬	三瀬
三瀬下	三瀬下
三瀬町	三瀬町
三熊	三熊
三牧	三牧
三狭間	三狭間
三獄	三獄
三玉	三玉
三王	三王
三王寺	三王寺
三珠	三珠
三瓶	三瓶
三甘	三甘
三生	三生
三用	三用
三甫	三甫
三田	三田
三田上	三田上
三田井	三田井
三田地	三田地
三田寺	三田寺
三田尻	三田尻
三田尾	三田尾
三田村	三田村
三田池	三田池
三田美	三田美
三田谷	三田谷
三田迫	三田迫
三田部	三田部
三田野	三田野
三由	三由
三甲野	三甲野
三町	三町
三界	三界
三畑	三畑
三留	三留
三畝	三畝
三畠	三畠
三畦	三畦
三番	三番
三登	三登
三百	三百
三百田	三百田
三百苅	三百苅
三皷	三皷
三盃	三盃
三盛	三盛
三目	三目
三省	三省
三県	三県
三矢	三矢
三矢城	三矢城
三矢島	三矢島
三矢本	三矢本
三矢田	三矢田
三知矢	三知矢
三石	三石
三砂	三砂
三社所	三社所
三神	三神
三神山	三神山
三福	三福
三福寺	三福寺
三秋	三秋
三科	三科
三程	三程
三種	三種
三穂	三穂
三穂野	三穂野
三穗野	三穗野
三窪	三窪
三立	三立
三竜	三竜
三竝	三竝
三竹	三竹
三竿	三竿
三笘	三笘
三笠	三笠
三笠屋	三笠屋
三笠木	三笠木
三笹	三笹
三箇	三箇
三箇尻	三箇尻
三箇山	三箇山
三箇島	三箇島
三箭	三箭
三箸	三箸
三節草	三節草
三築	三築
三簾	三簾
三籔	三籔
三糸	三糸
三納	三納
三紙	三紙
三続	三続
三綿	三綿
三緒	三緒
三縁	三縁
三縄	三縄
三縞	三縞
三縣	三縣
三繩	三繩
三美	三美
三義	三義
三羽	三羽
三者	三者
三聲	三聲
三股	三股
三脇	三脇
三腰	三腰
三膳	三膳
三與木	三與木
三舘	三舘
三舛	三舛
三舛木	三舛木
三舛畑	三舛畑
三舛谷	三舛谷
三舟	三舟
三舩	三舩
三船	三船
三良	三良
三良丸	三良丸
三艸	三艸
三芝	三芝
三芦	三芦
三芳	三芳
三芳野	三芳野
三苫	三苫
三草	三草
三荊	三荊
三荒	三荒
三荷	三荷
三荻	三荻
三菅	三菅
三華	三華
三葉	三葉
三葛	三葛
三葛木	三葛木
三蓼	三蓼
三蔭	三蔭
三蔵	三蔵
三薗	三薗
三薮	三薮
三藤	三藤
三藤田	三藤田
三藪	三藪
三行	三行
三行地	三行地
三裏	三裏
三見	三見
三角	三角
三角園	三角園
三角田	三角田
三觜	三觜
三計	三計
三記	三記
三訳	三訳
三調	三調
三諾	三諾
三譯	三譯
三谷	三谷
三谷原	三谷原
三谷山	三谷山
三谷川	三谷川
三谷本	三谷本
三谷沢	三谷沢
三谷澤	三谷澤
三谷野	三谷野
三谿	三谿
三豬	三豬
三貝	三貝
三貫納	三貫納
三貴	三貴
三賀	三賀
三賀山	三賀山
三賀本	三賀本
三賀森	三賀森
三賢	三賢
三越	三越
三足	三足
三路	三路
三身	三身
三軒	三軒
三軒家	三軒家
三軒屋	三軒屋
三軒谷	三軒谷
三輪	三輪
三輪出	三輪出
三輪屋	三輪屋
三輪山	三輪山
三輪木	三輪木
三輪橋	三輪橋
三輪浦	三輪浦
三輪田	三輪田
三輪谷	三輪谷
三輪野	三輪野
三輸	三輸
三辺	三辺
三辻	三辻
三近	三近
三迫	三迫
三迺	三迺
三通	三通
三通田	三通田
三逵	三逵
三道	三道
三達	三達
三達屋	三達屋
三邉	三邉
三邊	三邊
三邑	三邑
三那三	三那三
三那川	三那川
三邨	三邨
三郎丸	三郎丸
三郎迫	三郎迫
三部	三部
三郷	三郷
三都	三都
三都主	三都主
三都井	三都井
三里	三里
三重	三重
三重堀	三重堀
三重松	三重松
三重生	三重生
三重野	三重野
三野	三野
三野原	三野原
三野宮	三野宮
三野岡	三野岡
三野島	三野島
三野本	三野本
三野村	三野村
三野瀬	三野瀬
三野田	三野田
三野谷	三野谷
三野輪	三野輪
三金	三金
三釜田	三釜田
三鈷	三鈷
三録	三録
三鍋	三鍋
三鍵	三鍵
三鎌	三鎌
三鐘	三鐘
三鑰	三鑰
三長	三長
三門	三門
三門明	三門明
三間	三間
三間地	三間地
三間屋	三間屋
三間瀬	三間瀬
三間谷	三間谷
三関	三関
三阪	三阪
三附	三附
三隅	三隅
三隅田	三隅田
三隈	三隈
三階	三階
三階松	三階松
三随	三随
三隨	三隨
三雲	三雲
三露	三露
三須	三須
三須田	三須田
三須磨	三須磨
三頭	三頭
三頭谷	三頭谷
三餘	三餘
三館	三館
三馬	三馬
三駄	三駄
三駒	三駒
三高	三高
三鬼	三鬼
三鳥川	三鳥川
三鴨	三鴨
三鶴	三鶴
三鹿	三鹿
三鹿野	三鹿野
三黒	三黒
三黒江	三黒江
三鼓	三鼓
三龍	三龍
三𢌞部	三𢌞部
三𧮾	三𧮾
上一	上一
上万	上万
上三	上三
上三信	上三信
上三地	上三地
上三垣	上三垣
上三路	上三路
上八重	上八重
上四元	上四元
下一ノ宮	下一ノ宮
下万	下万
下二井	下二井
下八	下八
下八尻	下八尻
下八川	下八川
下八重	下八重
下四日市	下四日市
下志万	下志万
下松八重	下松八重
不二	不二
不二井	不二井
不二原	不二原
不二山	不二山
不二崎	不二崎
不二川	不二川
不二木	不二木
不二樹	不二樹
不二葦	不二葦
不二見	不二見
不二門	不二門
不可三	不可三
与一迫	与一迫
与三井	与三井
与三川	与三川
与三手	与三手
与三本	与三本
与三野	与三野
与五沢	与五沢
与五澤	与五澤
与十田	与十田
与四田	与四田
世ノ一	世ノ一
世一	世一
世六	世六
中一	中一
中七	中七
中万	中万
中三川	中三川
中三瀬	中三瀬
中二	中二
中八児	中八児
中六角	中六角
中十	中十
中千	中千
中千代	中千代
丸一	丸一
丸七	丸七
丸二	丸二
丸十	丸十
乃一	乃一
乃万	乃万
久一	久一
久七	久七
久万	久万
久万寿	久万寿
久万川	久万川
久万沢	久万沢
久万澤	久万澤
久万田	久万田
久八	久八
久百々	久百々
乙二	乙二
九々	九々
九ノ池	九ノ池
九ノ里	九ノ里
九万原	九万原
九万田	九万田
九之坪	九之坪
九之池	九之池
九乗	九乗
九井	九井
九会田	九会田
九住	九住
九佐	九佐
九保	九保
九俵	九俵
九内	九内
九冨	九冨
九刕	九刕
九十九沢	九十九沢
九十九澤	九十九澤
九十九田	九十九田
九十九里	九十九里
九十歩	九十歩
九十田	九十田
九十谷	九十谷
九千房	九千房
九原	九原
九反	九反
九反田	九反田
九司	九司
九合	九合
九喜	九喜
九坪	九坪
九城	九城
九埜	九埜
九堀	九堀
九家	九家
九富	九富
九尾	九尾
九山	九山
九岡	九岡
九島	九島
九嶋	九嶋
九川	九川
九平	九平
九座	九座
九後	九後
九徳	九徳
九志田	九志田
九戸	九戸
九手	九手
九折	九折
九日	九日
九星	九星
九曜	九曜
九會田	九會田
九木	九木
九木田	九木田
九木野	九木野
九本	九本
九村	九村
九条	九条
九東	九東
九栗	九栗
九條	九條
九次米	九次米
九沢	九沢
九河	九河
九法	九法
九津見	九津見
九浦	九浦
九海	九海
九渡	九渡
九澤	九澤
九猪	九猪
九玉	九玉
九田	九田
九町	九町
九目	九目
九矢	九矢
九石	九石
九社前	九社前
九穂	九穂
九笹	九笹
九綱	九綱
九翟	九翟
九能	九能
九良	九良
九良賀野	九良賀野
九良野	九良野
九萬原	九萬原
九藤	九藤
九蘭	九蘭
九角	九角
九護	九護
九谷	九谷
九谷田	九谷田
九貫	九貫
九賀	九賀
九軒	九軒
九郎丸	九郎丸
九郎座	九郎座
九郎明川	九郎明川
九郎田	九郎田
九郷	九郷
九里	九里
九里山	九里山
九里田	九里田
九重	九重
九重地	九重地
九重谷	九重谷
九重路	九重路
九野	九野
九野坂	九野坂
九野木	九野木
九野里	九野里
九門	九門
九間	九間
九頭	九頭
九頭竜	九頭竜
九頭竜坂	九頭竜坂
九頭見	九頭見
九頭龍	九頭龍
九頭龍坂	九頭龍坂
九首見	九首見
九高	九高
九鬼	九鬼
九鬼丸	九鬼丸
二っ家	二っ家
二の丸	二の丸
二の宮	二の宮
二の瀬	二の瀬
二タ川	二タ川
二タ月	二タ月
二タ村	二タ村
二タ見	二タ見
二ツ亀	二ツ亀
二ツ井	二ツ井
二ツ城	二ツ城
二ツ家	二ツ家
二ツ寺	二ツ寺
二ツ屋	二ツ屋
二ツ山	二ツ山
二ツ川	二ツ川
二ツ木	二ツ木
二ツ柳	二ツ柳
二ツ森	二ツ森
二ツ橋	二ツ橋
二ツ池	二ツ池
二ツ町	二ツ町
二ツ矢	二ツ矢
二ツ石	二ツ石
二ツ神	二ツ神
二ツ谷	二ツ谷
二ツ迫	二ツ迫
二ツ野	二ツ野
二ノ上	二ノ上
二ノ下	二ノ下
二ノ丸	二ノ丸
二ノ久保	二ノ久保
二ノ井	二ノ井
二ノ倉	二ノ倉
二ノ原	二ノ原
二ノ口	二ノ口
二ノ坂	二ノ坂
二ノ城	二ノ城
二ノ宮	二ノ宮
二ノ峰	二ノ峰
二ノ形	二ノ形
二ノ戸	二ノ戸
二ノ文	二ノ文
二ノ方	二ノ方
二ノ本	二ノ本
二ノ村	二ノ村
二ノ瀬	二ノ瀬
二ノ田	二ノ田
二ノ神	二ノ神
二ノ美屋	二ノ美屋
二ノ谷	二ノ谷
二ノ関	二ノ関
二丁田	二丁田
二万	二万
二三味	二三味
二三四	二三四
二三島	二三島
二上	二上
二世	二世
二串	二串
二丸	二丸
二丹	二丹
二丹田	二丹田
二久	二久
二久山	二久山
二之夕	二之夕
二之宮	二之宮
二之形	二之形
二之方	二之方
二之段	二之段
二之湯	二之湯
二之瀬	二之瀬
二之部	二之部
二五元	二五元
二五垰	二五垰
二五田	二五田
二井	二井
二井上	二井上
二井内	二井内
二井原	二井原
二井土	二井土
二井家	二井家
二井屋	二井屋
二井屋田	二井屋田
二井山	二井山
二井岡	二井岡
二井川	二井川
二井手	二井手
二井本	二井本
二井林	二井林
二井田	二井田
二井矢	二井矢
二井藤	二井藤
二井見	二井見
二井谷	二井谷
二井野	二井野
二井関	二井関
二亦	二亦
二位	二位
二位松	二位松
二位永	二位永
二位関	二位関
二佐	二佐
二保	二保
二俟	二俟
二俣	二俣
二元	二元
二六	二六
二出川	二出川
二分	二分
二分野	二分野
二十歩	二十歩
二十田	二十田
二十軒	二十軒
二十里	二十里
二原	二原
二又	二又
二又川	二又川
二叉	二叉
二叉川	二叉川
二反	二反
二反地	二反地
二反田	二反田
二反長	二反長
二口	二口
二口谷	二口谷
二司	二司
二名	二名
二味	二味
二和田	二和田
二唐	二唐
二問	二問
二善	二善
二喜	二喜
二四岡	二四岡
二国	二国
二國	二國
二坂	二坂
二坂谷	二坂谷
二坪	二坪
二垣	二垣
二基	二基
二堂	二堂
二場	二場
二塚	二塚
二夕川	二夕川
二夕見	二夕見
二多田	二多田
二子	二子
二子岩	二子岩
二子石	二子石
二字	二字
二宗	二宗
二宝	二宝
二宮	二宮
二家	二家
二家本	二家本
二尾	二尾
二居	二居
二居野	二居野
二山	二山
二岡	二岡
二岩	二岩
二岸	二岸
二峯	二峯
二峰	二峰
二島	二島
二崎	二崎
二嶋	二嶋
二川	二川
二川原	二川原
二川目	二川目
二幡	二幡
二平	二平
二平太	二平太
二弊?	二弊?
二張	二張
二戸	二戸
二戸部	二戸部
二所宮	二所宮
二挺木	二挺木
二摩	二摩
二改	二改
二敷	二敷
二文字	二文字
二文字屋	二文字屋
二斗蒔	二斗蒔
二斗蒔田	二斗蒔田
二斜	二斜
二方	二方
二日一	二日一
二日市	二日市
二星	二星
二曽	二曽
二替	二替
二月田	二月田
二木	二木
二木田	二木田
二本	二本
二本垣	二本垣
二本木	二本木
二本杉	二本杉
二本松	二本松
二本柳	二本柳
二本柿	二本柿
二本森	二本森
二本樹	二本樹
二本橋	二本橋
二杁	二杁
二杉	二杉
二村	二村
二条	二条
二条久保	二条久保
二条院	二条院
二松	二松
二林	二林
二枚田	二枚田
二枚畑	二枚畑
二枝	二枝
二柱	二柱
二柳	二柳
二柿	二柿
二栗	二栗
二栢	二栢
二株	二株
二梃木	二梃木
二條	二條
二條久保	二條久保
二森	二森
二椙	二椙
二楷堂	二楷堂
二標	二標
二橋	二橋
二次	二次
二正寺	二正寺
二武	二武
二歩	二歩
二段	二段
二殿	二殿
二永	二永
二江	二江
二沢	二沢
二沢平	二沢平
二河	二河
二河田	二河田
二法田	二法田
二津	二津
二津谷	二津谷
二浦	二浦
二浦尾	二浦尾
二浪	二浪
二渡	二渡
二滝	二滝
二澤	二澤
二澤平	二澤平
二瀧	二瀧
二瀬	二瀬
二瀬川	二瀬川
二熊	二熊
二片	二片
二牟礼	二牟礼
二牟禮	二牟禮
二牧畑	二牧畑
二王堂	二王堂
二王頭	二王頭
二瓶	二瓶
二田	二田
二田原	二田原
二田口	二田口
二田水	二田水
二町	二町
二畑	二畑
二畠	二畠
二百寺	二百寺
二百田	二百田
二目	二目
二矢	二矢
二矢川	二矢川
二矢田	二矢田
二石	二石
二礼	二礼
二礼木	二礼木
二社谷	二社谷
二祖	二祖
二神	二神
二禮木	二禮木
二科	二科
二穴	二穴
二窓	二窓
二籐	二籐
二継	二継
二羽	二羽
二股	二股
二艘木	二艘木
二艘舟	二艘舟
二色	二色
二若	二若
二茅	二茅
二荒	二荒
二葉	二葉
二薮	二薮
二藤	二藤
二藤部	二藤部
二見	二見
二見屋	二見屋
二見谷	二見谷
二角	二角
二谷	二谷
二谷島	二谷島
二貝	二貝
二賀木	二賀木
二越	二越
二軒谷	二軒谷
二輪	二輪
二通	二通
二連木	二連木
二道	二道
二邨	二邨
二郎丸	二郎丸
二部	二部
二部野	二部野
二郷	二郷
二里	二里
二里木	二里木
二重	二重
二重作	二重作
二重谷	二重谷
二野	二野
二野上	二野上
二野下	二野下
二野井	二野井
二野塀	二野塀
二野宮	二野宮
二野屏	二野屏
二野川	二野川
二野戸	二野戸
二野瀬	二野瀬
二野瓶	二野瓶
二門	二門
二間	二間
二間戸	二間戸
二間瀬	二間瀬
二関	二関
二隅	二隅
二階	二階
二階堂	二階堂
二階戸	二階戸
二階蔵	二階蔵
二階藏	二階藏
二階谷	二階谷
二面	二面
二飯田	二飯田
二馬	二馬
二鹿	二鹿
五の井	五の井
五の坪	五の坪
五ケ山	五ケ山
五ケ市	五ケ市
五ケ谷	五ケ谷
五ノ上	五ノ上
五ノ井	五ノ井
五ノ坪	五ノ坪
五ノ田	五ノ田
五ノ谷	五ノ谷
五丁	五丁
五丁森	五丁森
五万戸	五万戸
五三	五三
五上	五上
五下	五下
五丸	五丸
五丹	五丹
五之治	五之治
五乙女	五乙女
五井	五井
五井山	五井山
五井淵	五井淵
五井渕	五井渕
五井野	五井野
五代	五代
五代儀	五代儀
五伝木	五伝木
五位	五位
五位堂	五位堂
五位塚	五位塚
五位尾	五位尾
五位淵	五位淵
五位渕	五位渕
五位野	五位野
五來	五來
五傳木	五傳木
五内川	五内川
五冨利	五冨利
五刀	五刀
五分木	五分木
五利江	五利江
五前	五前
五加	五加
五勝出	五勝出
五十井	五十井
五十井田	五十井田
五十代	五十代
五十住	五十住
五十免	五十免
五十公野	五十公野
五十内	五十内
五十刈	五十刈
五十右	五十右
五十君	五十君
五十地	五十地
五十場	五十場
五十子	五十子
五十実	五十実
五十實	五十實
五十山田	五十山田
五十峯	五十峯
五十峰	五十峰
五十島	五十島
五十崎	五十崎
五十嵐	五十嵐
五十嶋	五十嶋
五十嶺	五十嶺
五十川	五十川
五十州	五十州
五十幡	五十幡
五十木	五十木
五十村	五十村
五十栖	五十栖
五十森	五十森
五十棲	五十棲
五十樓	五十樓
五十殿	五十殿
五十沢	五十沢
五十洲	五十洲
五十澤	五十澤
五十玉	五十玉
五十田	五十田
五十畑	五十畑
五十畠	五十畠
五十石	五十石
五十立	五十立
五十苅	五十苅
五十谷	五十谷
五十貝	五十貝
五十部	五十部
五十里	五十里
五十里屋	五十里屋
五十野	五十野
五十鈴	五十鈴
五十鈴川	五十鈴川
五十風	五十風
五十香	五十香
五升田	五升田
五升目	五升目
五反	五反
五反分	五反分
五反地	五反地
五反田	五反田
五反田屋	五反田屋
五古	五古
五名	五名
五呂	五呂
五味	五味
五味之本	五味之本
五味原	五味原
五味多	五味多
五味岡	五味岡
五味川	五味川
五味本	五味本
五味沢	五味沢
五味淵	五味淵
五味渕	五味渕
五味澤	五味澤
五味田	五味田
五和宮	五和宮
五唐	五唐
五喜田	五喜田
五坊	五坊
五坪	五坪
五城	五城
五堂	五堂
五大	五大
五大院	五大院
五天	五天
五太代	五太代
五太子	五太子
五字	五字
五孝	五孝
五安	五安
五安城	五安城
五官	五官
五定	五定
五宝	五宝
五宮	五宮
五家	五家
五寧	五寧
五寳	五寳
五寶	五寶
五対	五対
五對	五對
五屋	五屋
五山	五山
五岩	五岩
五峯	五峯
五島	五島
五島屋	五島屋
五崎	五崎
五嵐	五嵐
五嵐川	五嵐川
五嶋	五嶋
五嶋屋	五嶋屋
五嶌	五嶌
五川	五川
五師	五師
五幣	五幣
五幤	五幤
五平地	五平地
五幾谷	五幾谷
五座	五座
五庵	五庵
五弊	五弊
五弓	五弓
五影	五影
五影堂	五影堂
五得	五得
五徳	五徳
五戸	五戸
五所	五所
五所尾	五所尾
五所村	五所村
五所野尾	五所野尾
五拾免	五拾免
五敷	五敷
五斗	五斗
五斗田	五斗田
五斗蒔	五斗蒔
五日市	五日市
五明	五明
五明田	五明田
五智	五智
五月	五月
五月女	五月女
五月日	五月日
五月田	五月田
五木	五木
五木本	五木本
五木田	五木田
五木谷	五木谷
五本	五本
五本上	五本上
五本木	五本木
五本松	五本松
五村	五村
五条	五条
五条堀	五条堀
五条川	五条川
五条方	五条方
五来	五来
五東	五東
五林	五林
五枚橋	五枚橋
五枝	五枝
五枡本	五枡本
五桝本	五桝本
五條	五條
五條堀	五條堀
五條歩	五條歩
五次	五次
五歩一	五歩一
五歩市	五歩市
五歩池	五歩池
五殿	五殿
五水井	五水井
五江淵	五江淵
五江渕	五江渕
五沢	五沢
五泉	五泉
五津	五津
五浦	五浦
五海	五海
五瀬	五瀬
五熊	五熊
五王	五王
五瓶	五瓶
五田	五田
五由出	五由出
五町	五町
五町森	五町森
五畑	五畑
五畿田	五畿田
五百	五百
五百久	五百久
五百井	五百井
五百住	五百住
五百倉	五百倉
五百原	五百原
五百城	五百城
五百尾	五百尾
五百山	五百山
五百島	五百島
五百崎	五百崎
五百川	五百川
五百扇	五百扇
五百旗部	五百旗部
五百旗頭	五百旗頭
五百木	五百木
五百森	五百森
五百沢	五百沢
五百澤	五百澤
五百瀬	五百瀬
五百田	五百田
五百目	五百目
五百磐	五百磐
五百竹	五百竹
五百籏頭	五百籏頭
五百蔵	五百蔵
五百藏	五百藏
五百路	五百路
五百部	五百部
五百野	五百野
五百雀	五百雀
五石	五石
五社	五社
五社谷	五社谷
五神	五神
五福	五福
五穀	五穀
五端	五端
五筒	五筒
五箇	五箇
五箇谷	五箇谷
五箇野	五箇野
五籐	五籐
五網	五網
五老	五老
五老海	五老海
五耒	五耒
五舛出	五舛出
五舛目	五舛目
五艘	五艘
五良	五良
五良島	五良島
五良水	五良水
五色	五色
五荘	五荘
五葉	五葉
五葉木	五葉木
五葉谷	五葉谷
五藤	五藤
五行	五行
五見	五見
五角	五角
五谷	五谷
五貝	五貝
五貫	五貫
五賀	五賀
五軒家	五軒家
五軒浜	五軒浜
五軒濱	五軒濱
五軒矢	五軒矢
五輪	五輪
五辺	五辺
五辻	五辻
五通	五通
五道	五道
五邉	五邉
五郎	五郎
五郎三	五郎三
五郎丸	五郎丸
五郎地	五郎地
五郎大	五郎大
五郎尾	五郎尾
五郎島	五郎島
五郎川	五郎川
五郎水	五郎水
五郎畑	五郎畑
五郎谷	五郎谷
五郎部	五郎部
五郡	五郡
五酔	五酔
五里地	五里地
五里守	五里守
五里川原	五里川原
五里江	五里江
五重目	五重目
五野	五野
五野上	五野上
五野井	五野井
五閑	五閑
五間	五間
五間岩	五間岩
五間長	五間長
五関	五関
五阿味	五阿味
五阿弥	五阿弥
五阿彌	五阿彌
五陸	五陸
五雲寺	五雲寺
五領	五領
五領田	五領田
五頭	五頭
五香	五香
五香屋	五香屋
五鬼上	五鬼上
五鬼助	五鬼助
五鬼田	五鬼田
五鬼継	五鬼継
五鹿	五鹿
五龍神田	五龍神田
井ノ一	井ノ一
井一	井一
井二	井二
仁八	仁八
今一	今一
今八幡	今八幡
仲三河	仲三河
仲二見	仲二見
伊万里	伊万里
伊三木	伊三木
伊三部	伊三部
伊三野	伊三野
伊五沢	伊五沢
伊五澤	伊五澤
伊千	伊千
伍十川	伍十川
休万	休万
伝四	伝四
佐二木	佐二木
佐八	佐八
佐美三	佐美三
余百	余百
倉八	倉八
倉富二	倉富二
儀万	儀万
儀三武	儀三武
元二	元二
入一	入一
入万	入万
入不二	入不二
八つ代	八つ代
八ケ代	八ケ代
八ケ婦	八ケ婦
八ケ窪	八ケ窪
八ツ井	八ツ井
八ツ代	八ツ代
八ツ元	八ツ元
八ツ塚	八ツ塚
八ツ尾	八ツ尾
八ツ山	八ツ山
八ツ岩	八ツ岩
八ツ峰	八ツ峰
八ツ崎	八ツ崎
八ツ役	八ツ役
八ツ星	八ツ星
八ツ木	八ツ木
八ツ本	八ツ本
八ツ柳	八ツ柳
八ツ橋	八ツ橋
八ツ波	八ツ波
八ツ浦	八ツ浦
八ツ田	八ツ田
八ツ繁	八ツ繁
八ツ藤	八ツ藤
八ツ賀	八ツ賀
八丁	八丁
八丁地	八丁地
八丁目	八丁目
八丁野	八丁野
八七橋	八七橋
八万	八万
八万木	八万木
八丈	八丈
八丈野	八丈野
八上	八上
八下田	八下田
八与	八与
八世山	八世山
八並	八並
八串	八串
八丸	八丸
八丹	八丹
八久	八久
八久保	八久保
八乕	八乕
八乙女	八乙女
八九	八九
八亀	八亀
八五郎丸	八五郎丸
八井	八井
八井沢	八井沢
八井田	八井田
八京	八京
八代	八代
八代田	八代田
八代谷	八代谷
八代醍	八代醍
八伏	八伏
八住	八住
八作	八作
八俣	八俣
八倉	八倉
八倉巻	八倉巻
八元	八元
八光	八光
八児	八児
八兒	八兒
八内	八内
八切	八切
八別当	八別当
八別當	八別當
八前	八前
八剣	八剣
八剱	八剱
八劒	八劒
八劔	八劔
八力	八力
八加部	八加部
八十	八十
八十住	八十住
八十八	八十八
八十出	八十出
八十原	八十原
八十山	八十山
八十岡	八十岡
八十島	八十島
八十嶋	八十嶋
八十川	八十川
八十広	八十広
八十木	八十木
八十歩	八十歩
八十河	八十河
八十浜	八十浜
八十濱	八十濱
八十瀬	八十瀬
八十田	八十田
八十科	八十科
八千	八千
八千代	八千代
八千古島	八千古島
八千古嶋	八千古嶋
八千田	八千田
八卷	八卷
八原	八原
八又	八又
八友	八友
八反	八反
八反丸	八反丸
八反地	八反地
八反田	八反田
八取	八取
八司	八司
八合	八合
八名	八名
八名木	八名木
八向	八向
八吹	八吹
八周	八周
八和田	八和田
八品	八品
八国	八国
八国生	八国生
八國	八國
八國生	八國生
八地又	八地又
八坂	八坂
八垣	八垣
八垰	八垰
八城	八城
八塔	八塔
八塚	八塚
八塩	八塩
八壁	八壁
八声	八声
八壽八	八壽八
八多	八多
八多川	八多川
八太	八太
八夫	八夫
八子	八子
八子熊	八子熊
八字	八字
八宗岡	八宗岡
八宮	八宮
八家	八家
八富	八富
八寿八	八寿八
八寿田	八寿田
八尋	八尋
八尋淵	八尋淵
八尋渕	八尋渕
八尺	八尺
八尻	八尻
八尾	八尾
八尾井	八尾井
八尾坂	八尾坂
八尾師	八尾師
八尾村	八尾村
八尾板	八尾板
八尾田	八尾田
八尾谷	八尾谷
八尾野	八尾野
八屋	八屋
八山	八山
八岡	八岡
八岩	八岩
八峠	八峠
八島	八島
八崎	八崎
八嵜	八嵜
八嶋	八嶋
八嶌	八嶌
八川	八川
八巻	八巻
八幡	八幡
八幡原	八幡原
八幡垣	八幡垣
八幡屋	八幡屋
八幡木	八幡木
八幡秋山	八幡秋山
八幡谷	八幡谷
八幡野	八幡野
八幡領	八幡領
八平	八平
八幾井	八幾井
八広	八広
八度	八度
八廣	八廣
八張	八張
八影	八影
八役	八役
八性	八性
八惣	八惣
八懸	八懸
八戸	八戸
八戸木	八戸木
八戸野	八戸野
八房	八房
八所	八所
八手	八手
八手亦	八手亦
八手又	八手又
八手幡	八手幡
八括	八括
八掛	八掛
八敷	八敷
八文字	八文字
八斗	八斗
八方	八方
八旗	八旗
八日	八日
八日囿	八日囿
八日園	八日園
八日市	八日市
八日市屋	八日市屋
八日市谷	八日市谷
八明	八明
八星	八星
八景	八景
八月朔日	八月朔日
八朔	八朔
八朔日	八朔日
八朝	八朝
八木	八木
八木ケ谷	八木ケ谷
八木下	八木下
八木井	八木井
八木原	八木原
八木司	八木司
八木場	八木場
八木尾	八木尾
八木山	八木山
八木岡	八木岡
八木島	八木島
八木巻	八木巻
八木平	八木平
八木庭	八木庭
八木戸	八木戸
八木本	八木本
八木森	八木森
八木橋	八木橋
八木沢	八木沢
八木沼	八木沼
八木澤	八木澤
八木田	八木田
八木谷	八木谷
八木野	八木野
八本	八本
八本木	八本木
八杉	八杉
八村	八村
八杖	八杖
八束	八束
八条	八条
八東	八東
八松	八松
八板	八板
八林	八林
八柄	八柄
八柏	八柏
八染	八染
八柳	八柳
八栗	八栗
八桁	八桁
八條	八條
八森	八森
八槇	八槇
八構	八構
八槙	八槙
八槻	八槻
八樹	八樹
八橋	八橋
八次	八次
八武崎	八武崎
八段	八段
八毛	八毛
八永	八永
八汐	八汐
八江	八江
八沢	八沢
八河	八河
八波	八波
八波田	八波田
八津	八津
八津倉	八津倉
八津又	八津又
八津口	八津口
八津尾	八津尾
八津川	八津川
八津橋	八津橋
八津田	八津田
八津谷	八津谷
八洲	八洲
八浜	八浜
八浦	八浦
八浪	八浪
八海	八海
八淵	八淵
八渓	八渓
八渡	八渡
八源寺	八源寺
八潮	八潮
八澤	八澤
八濱	八濱
八瀬	八瀬
八瀬尾	八瀬尾
八瀬山	八瀬山
八瀬川	八瀬川
八瀬林	八瀬林
八瀬河	八瀬河
八瀬辺	八瀬辺
八瀬邉	八瀬邉
八熊	八熊
八牟礼	八牟礼
八牟禮	八牟禮
八牧	八牧
八王	八王
八王地	八王地
八王子	八王子
八甫谷	八甫谷
八田	八田
八田井	八田井
八田原	八田原
八田堀	八田堀
八田羽	八田羽
八田谷	八田谷
八田部	八田部
八田野	八田野
八甲田	八甲田
八町	八町
八畑	八畑
八畝田	八畝田
八畠	八畠
八登	八登
八百	八百
八百三	八百三
八百下	八百下
八百中	八百中
八百井	八百井
八百代	八百代
八百原	八百原
八百坂	八百坂
八百城	八百城
八百屋	八百屋
八百山	八百山
八百川	八百川
八百市	八百市
八百幸	八百幸
八百木	八百木
八百本	八百本
八百村	八百村
八百板	八百板
八百枝	八百枝
八百田	八百田
八百谷	八百谷
八百野	八百野
八的	八的
八矢	八矢
八石	八石
八社宮	八社宮
八神	八神
八穴	八穴
八窪	八窪
八端	八端
八竹	八竹
八符	八符
八筈	八筈
八筬	八筬
八箇	八箇
八篠	八篠
八籏	八籏
八納	八納
八絛	八絛
八綿	八綿
八羽	八羽
八羽毛	八羽毛
八耳	八耳
八聲	八聲
八與	八與
八舟	八舟
八船	八船
八色	八色
八若	八若
八荷	八荷
八萬	八萬
八葉	八葉
八蕪	八蕪
八藤	八藤
八藤丸	八藤丸
八藤後	八藤後
八角	八角
八記	八記
八講	八講
八谷	八谷
八賀	八賀
八起	八起
八越	八越
八車	八車
八軒	八軒
八軒屋	八軒屋
八輪	八輪
八辺	八辺
八辻	八辻
八道	八道
八郎田	八郎田
八部	八部
八部野	八部野
八郷	八郷
八里	八里
八重	八重
八重下	八重下
八重代	八重代
八重倉	八重倉
八重元	八重元
八重原	八重原
八重口	八重口
八重垣	八重垣
八重尾	八重尾
八重山	八重山
八重岡	八重岡
八重岳	八重岳
八重島	八重島
八重崎	八重崎
八重嶋	八重嶋
八重嶌	八重嶌
八重嶽	八重嶽
八重川	八重川
八重幡	八重幡
八重座	八重座
八重木	八重木
八重本	八重本
八重柏	八重柏
八重桓	八重桓
八重桜	八重桜
八重森	八重森
八重樫	八重樫
八重橋	八重橋
八重櫻	八重櫻
八重沢	八重沢
八重津	八重津
八重澤	八重澤
八重田	八重田
八重畑	八重畑
八重盛	八重盛
八重石	八重石
八重練	八重練
八重見	八重見
八重野	八重野
八重門	八重門
八野	八野
八野井	八野井
八野田	八野田
八釖	八釖
八釜	八釜
八釣	八釣
八釼	八釼
八鍬	八鍬
八鎌	八鎌
八長	八長
八間	八間
八間川	八間川
八阪	八阪
八陣	八陣
八陳	八陳
八隅	八隅
八雲	八雲
八雲井	八雲井
八面	八面
八鞍	八鞍
八須	八須
八須元	八須元
八須賀	八須賀
八頭	八頭
八頭司	八頭司
八馬	八馬
八高	八高
八鬼	八鬼
八鳥	八鳥
八鹿	八鹿
八黄地	八黄地
六ケ村	六ケ村
六ツ名	六ツ名
六ツ崎	六ツ崎
六ツ役	六ツ役
六ツ森	六ツ森
六ツ石	六ツ石
六ツ見	六ツ見
六万	六万
六与	六与
六串	六串
六井	六井
六人石	六人石
六人部	六人部
六信	六信
六倉	六倉
六十田	六十田
六十苅	六十苅
六十谷	六十谷
六十里	六十里
六厩	六厩
六名	六名
六呂田	六呂田
六坂	六坂
六塚	六塚
六宗	六宗
六室	六室
六尾	六尾
六山	六山
六岡	六岡
六峯	六峯
六峰	六峰
六崎	六崎
六川	六川
六平	六平
六戸部	六戸部
六日市	六日市
六枝	六枝
六楽内	六楽内
六津井	六津井
六浦	六浦
六田	六田
六碕	六碕
六笠	六笠
六與	六與
六興	六興
六萬	六萬
六藤	六藤
六角	六角
六角屋	六角屋
六谷	六谷
六車	六車
六軒	六軒
六辻	六辻
六連	六連
六野	六野
六釜	六釜
六鎗	六鎗
六門	六門
六雄	六雄
六鹿	六鹿
兵万	兵万
兵三	兵三
兼八	兼八
内一	内一
内之八重	内之八重
内八重	内八重
円一	円一
初一	初一
前三盛	前三盛
副万	副万
加三	加三
加九	加九
加二倉	加二倉
加二谷	加二谷
加五元	加五元
加千須	加千須
加百	加百
加篭六	加篭六
加籠六	加籠六
勘七	勘七
勘六野	勘六野
勝二	勝二
勢一	勢一
勢万	勢万
北一	北一
北七	北七
北八	北八
北八代	北八代
十々木	十々木
十ノ目	十ノ目
十一家	十一家
十一谷	十一谷
十七夜月	十七夜月
十七女	十七女
十七部	十七部
十七里	十七里
十中	十中
十丸	十丸
十久保	十久保
十九川	十九川
十九本	十九本
十九波	十九波
十九浦	十九浦
十九百	十九百
十亀	十亀
十二丁	十二丁
十二役	十二役
十二所	十二所
十二村	十二村
十二林	十二林
十二町	十二町
十二谷	十二谷
十二里	十二里
十二野	十二野
十代	十代
十代田	十代田
十住	十住
十佐近	十佐近
十信田	十信田
十倉	十倉
十倍	十倍
十八公	十八公
十六原	十六原
十六沢	十六沢
十六澤	十六澤
十前	十前
十十木	十十木
十南	十南
十原	十原
十司	十司
十合	十合
十名	十名
十和	十和
十和田	十和田
十場	十場
十塚	十塚
十字	十字
十家	十家
十屋	十屋
十山	十山
十島	十島
十川	十川
十左近	十左近
十市	十市
十府	十府
十役	十役
十徳	十徳
十志田	十志田
十念	十念
十手山	十手山
十持	十持
十握	十握
十文字	十文字
十日市	十日市
十日谷	十日谷
十朱	十朱
十村	十村
十束	十束
十条	十条
十松	十松
十林	十林
十枝	十枝
十枝内	十枝内
十根川	十根川
十森	十森
十楚	十楚
十楽	十楽
十楽寺	十楽寺
十河	十河
十津	十津
十津川	十津川
十玉	十玉
十王	十王
十王寺	十王寺
十王舘	十王舘
十王館	十王館
十田	十田
十石	十石
十祖	十祖
十神	十神
十良	十良
十良沢	十良沢
十良澤	十良澤
十菱	十菱
十萬	十萬
十蔵寺	十蔵寺
十蟹	十蟹
十見	十見
十角	十角
十輪地	十輪地
十返	十返
十連地	十連地
十郎	十郎
十部	十部
十都	十都
十重田	十重田
十野	十野
十門地	十門地
十阿弥	十阿弥
十阿彌	十阿彌
十露木	十露木
十鳥	十鳥
千々和	千々和
千々岩	千々岩
千々布	千々布
千々木	千々木
千々村	千々村
千々松	千々松
千々波	千々波
千々石	千々石
千々谷	千々谷
千々輪	千々輪
千々部	千々部
千々野	千々野
千が崎	千が崎
千ケ崎	千ケ崎
千ノ木	千ノ木
千ノ本	千ノ本
千丈	千丈
千三木	千三木
千上	千上
千且	千且
千並	千並
千中	千中
千丸	千丸
千久田	千久田
千久谷	千久谷
千久間	千久間
千之巣	千之巣
千之木	千之木
千之本	千之本
千井	千井
千井野	千井野
千京	千京
千仏	千仏
千代	千代
千代世	千代世
千代丸	千代丸
千代住	千代住
千代倉	千代倉
千代原	千代原
千代反田	千代反田
千代園	千代園
千代坂	千代坂
千代山	千代山
千代岡	千代岡
千代島	千代島
千代崎	千代崎
千代川	千代川
千代延	千代延
千代政	千代政
千代木	千代木
千代本	千代本
千代村	千代村
千代松	千代松
千代森	千代森
千代樵	千代樵
千代永	千代永
千代沢	千代沢
千代浦	千代浦
千代澤	千代澤
千代田	千代田
千代留	千代留
千代盛	千代盛
千代窪	千代窪
千代薗	千代薗
千代藤	千代藤
千代西尾	千代西尾
千代谷	千代谷
千代野	千代野
千代間	千代間
千代鶴	千代鶴
千伝	千伝
千住	千住
千佐	千佐
千保	千保
千保木	千保木
千俵	千俵
千倉	千倉
千傳	千傳
千僧供	千僧供
千先	千先
千光	千光
千光士	千光士
千光寺	千光寺
千児島	千児島
千切	千切
千切谷	千切谷
千刈	千刈
千利浜	千利浜
千利濱	千利濱
千割	千割
千力	千力
千勝	千勝
千北	千北
千千和	千千和
千千松	千千松
千千波	千千波
千千石	千千石
千千輪	千千輪
千原	千原
千口	千口
千古	千古
千台	千台
千司	千司
千合	千合
千吉良	千吉良
千同	千同
千名	千名
千名原	千名原
千味	千味
千品	千品
千喜田	千喜田
千喜良	千喜良
千国	千国
千國	千國
千土	千土
千地	千地
千地丸	千地丸
千地岩	千地岩
千坂	千坂
千坊	千坊
千垣内	千垣内
千城	千城
千埜	千埜
千堂	千堂
千場	千場
千塚	千塚
千塲	千塲
千壽	千壽
千多	千多
千守	千守
千安	千安
千室	千室
千家	千家
千寺丸	千寺丸
千寿	千寿
千尋	千尋
千尺	千尺
千尾	千尾
千屋	千屋
千山	千山
千島	千島
千崎	千崎
千嵐	千嵐
千嵜	千嵜
千嶋	千嶋
千嶌	千嶌
千巌	千巌
千巖	千巖
千川	千川
千川原	千川原
千巣	千巣
千布	千布
千年	千年
千年原	千年原
千年屋	千年屋
千広	千広
千廣	千廣
千引	千引
千後	千後
千後滝	千後滝
千後瀧	千後瀧
千徳	千徳
千応山	千応山
千應山	千應山
千成	千成
千戝	千戝
千房	千房
千手	千手
千手間	千手間
千才	千才
千把	千把
千抦	千抦
千振	千振
千斛	千斛
千日	千日
千日坂	千日坂
千旦	千旦
千早	千早
千明	千明
千星	千星
千智岩	千智岩
千智松	千智松
千曳	千曳
千月	千月
千木	千木
千木崎	千木崎
千木穂	千木穂
千木良	千木良
千木里	千木里
千木野	千木野
千本	千本
千本木	千本木
千本松	千本松
千朿	千朿
千杉	千杉
千村	千村
千束	千束
千条	千条
千東	千東
千松	千松
千林	千林
千枝	千枝
千柄	千柄
千根	千根
千桐	千桐
千桜	千桜
千桝	千桝
千條	千條
千棒	千棒
千森	千森
千檀	千檀
千櫻	千櫻
千正	千正
千歩	千歩
千歳	千歳
千歳丸	千歳丸
千水	千水
千江	千江
千沢	千沢
千沢口	千沢口
千河	千河
千治松	千治松
千波	千波
千津井	千津井
千浜	千浜
千浦	千浦
千海	千海
千滝	千滝
千澤	千澤
千澤口	千澤口
千濱	千濱
千烝	千烝
千焏	千焏
千熊	千熊
千玉	千玉
千生	千生
千田	千田
千田口	千田口
千田谷	千田谷
千町	千町
千畑	千畑
千疋	千疋
千登勢	千登勢
千百松	千百松
千盤	千盤
千目	千目
千眼	千眼
千矢	千矢
千知	千知
千知岩	千知岩
千知松	千知松
千知波	千知波
千石	千石
千石谷	千石谷
千神	千神
千福	千福
千福地	千福地
千秋	千秋
千種	千種
千穐	千穐
千竃	千竃
千竈	千竈
千竜	千竜
千端	千端
千笠	千笠
千管	千管
千籐	千籐
千絛	千絛
千綾	千綾
千綿	千綿
千羽	千羽
千股	千股
千能	千能
千脇	千脇
千舘	千舘
千舩	千舩
千船	千船
千艘	千艘
千良	千良
千色	千色
千艸	千艸
千苅	千苅
千草	千草
千菅	千菅
千菊	千菊
千葉	千葉
千葉井	千葉井
千葉原	千葉原
千葉山	千葉山
千葉崎	千葉崎
千葉東	千葉東
千葉桜	千葉桜
千葉櫻	千葉櫻
千蒲	千蒲
千蔵	千蔵
千藏	千藏
千藤	千藤
千虎	千虎
千行	千行
千装	千装
千見寺	千見寺
千覚原	千覚原
千谷	千谷
千貝	千貝
千財	千財
千財丸	千財丸
千貫	千貫
千賀	千賀
千賀浦	千賀浦
千足	千足
千車	千車
千載	千載
千輝	千輝
千輪	千輪
千速	千速
千道	千道
千達	千達
千邑	千邑
千部	千部
千郷	千郷
千酌	千酌
千里	千里
千里久	千里久
千里内	千里内
千重	千重
千野	千野
千野原	千野原
千野根	千野根
千野田	千野田
千野辺	千野辺
千金	千金
千金楽	千金楽
千金良	千金良
千釜	千釜
千間	千間
千阪	千阪
千陽	千陽
千隝	千隝
千須和	千須和
千頭	千頭
千頭井	千頭井
千頭和	千頭和
千香	千香
千馬	千馬
千駄	千駄
千高	千高
千鳥	千鳥
千鶴	千鶴
千鹿野	千鹿野
千龍	千龍
千𥧄	千𥧄
升一	升一
南八重	南八重
南百瀬	南百瀬
参三	参三
古一	古一
古三庄	古三庄
古伊万里	古伊万里
古八	古八
古六	古六
古家一	古家一
可二生	可二生
合六	合六
吉八木	吉八木
吹一	吹一
味八木	味八木
善万	善万
喜三	喜三
四つ橋	四つ橋
四つ目	四つ目
四の宮	四の宮
四ケ所	四ケ所
四ケ浦	四ケ浦
四ケ田	四ケ田
四ケ谷	四ケ谷
四ケ野	四ケ野
四ツ井	四ツ井
四ツ井田	四ツ井田
四ツ倉	四ツ倉
四ツ分	四ツ分
四ツ塚	四ツ塚
四ツ家	四ツ家
四ツ居	四ツ居
四ツ屋	四ツ屋
四ツ岳	四ツ岳
四ツ島	四ツ島
四ツ嶋	四ツ嶋
四ツ嶽	四ツ嶽
四ツ役	四ツ役
四ツ木	四ツ木
四ツ村	四ツ村
四ツ柳	四ツ柳
四ツ橋	四ツ橋
四ツ永	四ツ永
四ツ滝	四ツ滝
四ツ瀧	四ツ瀧
四ツ田	四ツ田
四ツ目	四ツ目
四ツ碇	四ツ碇
四ツ谷	四ツ谷
四ツ路	四ツ路
四ツ車	四ツ車
四ツ辻	四ツ辻
四ツ釜	四ツ釜
四ツ門	四ツ門
四ツ関	四ツ関
四ノ原	四ノ原
四ノ宮	四ノ宮
四七	四七
四万村	四万村
四万田	四万田
四下	四下
四丸	四丸
四丹	四丹
四之宮	四之宮
四井	四井
四井田	四井田
四伊	四伊
四位	四位
四位例	四位例
四住	四住
四作	四作
四俣	四俣
四俵	四俵
四倉	四倉
四元	四元
四冨	四冨
四分谷	四分谷
四十万谷	四十万谷
四十九院	四十九院
四十井	四十井
四十住	四十住
四十八願	四十八願
四十内	四十内
四十坊	四十坊
四十塚	四十塚
四十宮	四十宮
四十山	四十山
四十岡	四十岡
四十崎	四十崎
四十川	四十川
四十木	四十木
四十本	四十本
四十栄	四十栄
四十榮	四十榮
四十沢	四十沢
四十洲	四十洲
四十澤	四十澤
四十物	四十物
四十物谷	四十物谷
四十田	四十田
四十竹	四十竹
四十萬谷	四十萬谷
四十谷	四十谷
四十野	四十野
四反田	四反田
四国	四国
四國	四國
四坂	四坂
四坊	四坊
四垂	四垂
四堂	四堂
四塚	四塚
四夷	四夷
四女野	四女野
四季	四季
四宅	四宅
四宮	四宮
四宮田	四宮田
四家	四家
四家井	四家井
四富	四富
四尺	四尺
四尾	四尾
四居	四居
四屋	四屋
四山	四山
四岡	四岡
四島	四島
四嶋	四嶋
四川	四川
四平	四平
四広	四広
四度	四度
四廣	四廣
四役	四役
四徳	四徳
四恩	四恩
四戸	四戸
四戸岸	四戸岸
四手	四手
四手井	四手井
四折	四折
四斉谷	四斉谷
四斎谷	四斎谷
四斗	四斗
四斗辺	四斗辺
四斗邊	四斗邊
四方	四方
四方伝	四方伝
四方城	四方城
四方堂	四方堂
四方天	四方天
四方山	四方山
四方川	四方川
四方田	四方田
四方谷	四方谷
四方路	四方路
四日市	四日市
四日谷	四日谷
四月朔日	四月朔日
四木	四木
四本	四本
四本木	四本木
四本松	四本松
四杉	四杉
四村	四村
四条	四条
四林	四林
四枚田	四枚田
四枝	四枝
四柳	四柳
四栗	四栗
四條	四條
四橋	四橋
四歩一	四歩一
四氏	四氏
四水	四水
四沢	四沢
四津	四津
四津井	四津井
四津川	四津川
四津田	四津田
四津谷	四津谷
四浦	四浦
四海	四海
四淵	四淵
四渕	四渕
四潟	四潟
四澤	四澤
四熊	四熊
四牟田	四牟田
四王天	四王天
四田	四田
四町田	四町田
四畑	四畑
四畝町	四畝町
四登	四登
四百刈	四百刈
四百田	四百田
四百目	四百目
四百苅	四百苅
四目忠	四目忠
四碇	四碇
四礼	四礼
四禮	四禮
四竃	四竃
四竈	四竈
四童子	四童子
四篠	四篠
四籐	四籐
四維	四維
四脇	四脇
四至本	四至本
四良丸	四良丸
四茂野	四茂野
四葉	四葉
四蔵	四蔵
四藏	四藏
四藤	四藤
四衢	四衢
四角	四角
四角目	四角目
四谷	四谷
四越	四越
四車	四車
四軒家	四軒家
四軒町	四軒町
四辻	四辻
四通	四通
四通田	四通田
四道	四道
四達	四達
四邨	四邨
四郎丸	四郎丸
四郎園	四郎園
四郎田	四郎田
四重田	四重田
四野	四野
四野宮	四野宮
四野見	四野見
四釜	四釜
四鈴	四鈴
四鏡	四鏡
四門	四門
四間	四間
四間丁	四間丁
四関	四関
四阿	四阿
四静	四静
四飯	四飯
四馬田	四馬田
四鬼	四鬼
四鹿	四鹿
四齊谷	四齊谷
国ノ十	国ノ十
國ノ十	國ノ十
圓一	圓一
土一	土一
坂三	坂三
坂八	坂八
坂千代	坂千代
城一	城一
堀一	堀一
堂七	堂七
堂八	堂八
堂六	堂六
堰八	堰八
塚八	塚八
塩三	塩三
増百	増百
夏八木	夏八木
大万	大万
大三	大三
大三和	大三和
大三島	大三島
大三川	大三川
大三輪	大三輪
大九	大九
大二	大二
大五	大五
大八児	大八児
大八木	大八木
大六	大六
大六野	大六野
大千里	大千里
大四	大四
大志万	大志万
天一	天一
奇二	奇二
奥一	奥一
妙一	妙一
孫八	孫八
孫六	孫六
宅万	宅万
守一	守一
安千谷	安千谷
宗万	宗万
宮一	宮一
宮三	宮三
宮千代	宮千代
家千	家千
寺一	寺一
寺七	寺七
寺二	寺二
小一原	小一原
小万	小万
小三田	小三田
小三門	小三門
小二又	小二又
小二田	小二田
小二里	小二里
小八ケ代	小八ケ代
小八木	小八木
小八田	小八田
小八重	小八重
小六	小六
小千田	小千田
小千谷	小千谷
小四郎丸	小四郎丸
小椎八重	小椎八重
小田二	小田二
尺一	尺一
尾一	尾一
尾万	尾万
山一	山一
山七	山七
山三	山三
山二	山二
山八	山八
山六	山六
山千代	山千代
山百	山百
岡一	岡一
岡野一	岡野一
岩三	岩三
岩八重	岩八重
川七	川七
川九	川九
工一	工一
左三川	左三川
左衛門三郎	左衛門三郎
市万田	市万田
市六	市六
布一	布一
平八重	平八重
庄八	庄八
廿千	廿千
弐百免	弐百免
弥三川	弥三川
弥三谷	弥三谷
弥三須	弥三須
弥五	弥五
弥五郎丸	弥五郎丸
弥六	弥六
弥十郎	弥十郎
彌三川	彌三川
彌五郎丸	彌五郎丸
彌八	彌八
彌六	彌六
当六	当六
後一	後一
従二	従二
従二谷	従二谷
從二	從二
徳一	徳一
徳万	徳万
徳三	徳三
徳千代	徳千代
志万	志万
悪七	悪七
惣万	惣万
惣八	惣八
扇一	扇一
才一	才一
押三見	押三見
拾三原	拾三原
振五	振五
政二	政二
文殊四郎	文殊四郎
文珠四郎	文珠四郎
斉二	斉二
斉五沢	斉五沢
斎二	斎二
斎五沢	斎五沢
斎五澤	斎五澤
新九町	新九町
新二日市	新二日市
新八	新八
新四原	新四原
新歩一	新歩一
昼八	昼八
晝八	晝八
朝一	朝一
朝三	朝三
木一	木一
木三田	木三田
木佐一	木佐一
末一	末一
本九町	本九町
本二日市	本二日市
杉万	杉万
杉八合	杉八合
村万	村万
杢三	杢三
東一	東一
東一坊	東一坊
東一昉	東一昉
東万	東万
東三条	東三条
東九	東九
東九條	東九條
東二町	東二町
東五十川	東五十川
東八重	東八重
東四柳	東四柳
松一	松一
松七五三	松七五三
松三	松三
松二	松二
松八重	松八重
松千	松千
松四	松四
松百	松百
板八	板八
枡一	枡一
栗三	栗三
桝一	桝一
梅千野	梅千野
森一	森一
椎八重	椎八重
楠八重	楠八重
権八	権八
樫八重	樫八重
橘八重	橘八重
次六	次六
次郎万	次郎万
正一	正一
武一	武一
毛千	毛千
水六	水六
水四	水四
永一	永一
永二	永二
江六前	江六前
池一	池一
池三津	池三津
沖二	沖二
河二	河二
河千泰	河千泰
河千田	河千田
泉二	泉二
津九浦	津九浦
浜二	浜二
浜千代	浜千代
浜四津	浜四津
清三津	清三津
源九	源九
源五郎丸	源五郎丸
源六	源六
濱二	濱二
濱千代	濱千代
濱四津	濱四津
熊一	熊一
猪八重	猪八重
玉一	玉一
玉八	玉八
甚九	甚九
甚五	甚五
生一	生一
生三	生三
産一	産一
田一	田一
田万	田万
田万里	田万里
田二見	田二見
田二谷	田二谷
田千代	田千代
百々	百々
百々亀	百々亀
百々坂	百々坂
百々塚	百々塚
百々海	百々海
百々済	百々済
百々瀬	百々瀬
百々米木	百々米木
百々谷	百々谷
百々路	百々路
百々野	百々野
百丈	百丈
百上	百上
百中	百中
百丸	百丸
百井	百井
百代	百代
百元	百元
百冨	百冨
百出	百出
百刈	百刈
百勝	百勝
百北	百北
百千田	百千田
百南	百南
百原	百原
百合	百合
百合中	百合中
百合口	百合口
百合園	百合園
百合山	百合山
百合岡	百合岡
百合島	百合島
百合嶋	百合嶋
百合川	百合川
百合本	百合本
百合林	百合林
百合永	百合永
百合沢	百合沢
百合澤	百合澤
百合田	百合田
百合綱	百合綱
百合草	百合草
百合薗	百合薗
百合藤	百合藤
百合野	百合野
百合長	百合長
百名	百名
百地	百地
百坂	百坂
百坪	百坪
百垣	百垣
百堂	百堂
百塚	百塚
百家	百家
百富	百富
百寿	百寿
百尾	百尾
百山	百山
百岡	百岡
百岳	百岳
百島	百島
百崎	百崎
百嶋	百嶋
百川	百川
百市	百市
百師	百師
百度	百度
百引	百引
百成	百成
百我	百我
百戸	百戸
百春	百春
百木	百木
百木田	百木田
百木野	百木野
百本	百本
百村	百村
百束	百束
百松	百松
百枝	百枝
百橋	百橋
百次	百次
百武	百武
百歩	百歩
百毛	百毛
百永	百永
百江	百江
百沢	百沢
百治	百治
百津	百津
百浦	百浦
百海	百海
百済	百済
百渓	百渓
百溪	百溪
百澤	百澤
百濃	百濃
百濟	百濟
百瀬	百瀬
百生	百生
百田	百田
百町	百町
百畑	百畑
百留	百留
百百塚	百百塚
百目	百目
百目木	百目木
百目鬼	百目鬼
百相	百相
百石	百石
百積	百積
百竹	百竹
百花	百花
百萬	百萬
百衣	百衣
百谷	百谷
百貫	百貫
百足	百足
百足山	百足山
百軒	百軒
百道	百道
百部	百部
百都	百都
百里	百里
百野	百野
百長	百長
百間	百間
百間田	百間田
百間谷	百間谷
百雲	百雲
百鬼	百鬼
百鳥	百鳥
盛一	盛一
目七	目七
直一	直一
真一	真一
矢三	矢三
矢五田	矢五田
矢八	矢八
石三	石三
石五	石五
祖一	祖一
神一	神一
神八	神八
福一	福一
福万	福万
福三田	福三田
秋三	秋三
秋山八幡	秋山八幡
種五	種五
竒二	竒二
竜八	竜八
竹一	竹一
竹万	竹万
米一	米一
紀三井	紀三井
紺一	紺一
紺一向	紺一向
総三	総三
羽二塚	羽二塚
羽二木	羽二木
羽二生	羽二生
聞一	聞一
能一	能一
與一迫	與一迫
與三	與三
與三川	與三川
與三本	與三本
與三野	與三野
與五沢	與五沢
與五澤	與五澤
與四田	與四田
興五澤	興五澤
芝一	芝一
花八	花八
荒二井	荒二井
菊一	菊一
菊万	菊万
菊千	菊千
菖一	菖一
菰千葉	菰千葉
蔵五	蔵五
藏五	藏五
藤三	藤三
藤九	藤九
藤五	藤五
藤八	藤八
藤六	藤六
西万	西万
西二町	西二町
西五辻	西五辻
西八条	西八条
西八條	西八條
西四辻	西四辻
西阿十	西阿十
見一	見一
規矩一	規矩一
角一	角一
角七	角七
角三	角三
角二	角二
角五	角五
谷一	谷一
貮百免	貮百免
貳百免	貳百免
賀篭六	賀篭六
賀籠六	賀籠六
越三	越三
輿五澤	輿五澤
近万	近万
運万	運万
道三	道三
邑十	邑十
郷万	郷万
郷六	郷六
酒百	酒百
重三	重三
野一	野一
野一色	野一色
金一	金一
金七	金七
金万	金万
金三津	金三津
金五	金五
金田一	金田一
釜一	釜一
鉋六	鉋六
鍋九	鍋九
長一	長一
長三	長三
門三	門三
門三野	門三野
阿万	阿万
阿万瀬	阿万瀬
阿万田	阿万田
阿万野	阿万野
阿二	阿二
阿千輪	阿千輪
陣一	陣一
須一	須一
須百	須百
飯万島	飯万島
飾万	飾万
飾万津	飾万津
高一	高一
高二	高二
高三	高三
高三潴	高三潴
高三野	高三野
高八	高八
高八卦	高八卦
高八重	高八重
高千代	高千代
高千穂	高千穂
鬼ケ一	鬼ケ一
鬼一	鬼一
鬼十	鬼十
鹿篭六	鹿篭六
鹿籠六	鹿籠六
齋二	齋二
齋五澤	齋五澤
龍八	龍八