$	달러
$	미국 달러
$	미국 달러
£	영국 파운드
€	유로
₩	원
nzd	뉴질랜드 달러
rs	루피
chf	스위스 프랑
dkk	덴마크 크로네
fim	핀란드 마르카
aed	아랍 에미리트 디르함
¥	엔
czk	체코 코루나
mro	모리타니 우기야
pkr	파키스탄 루피
crc	코스타리카 콜론
hk$	홍콩 달러
npr	네팔 루피
awg	아루반 플로린
nok	노르웨이 크로네
tzs	탄자니아 실링
sek	스웨덴 크로나
cyp	키프로스 파운드
sar	사우디 리얄
cve	케이프 베르데 에스쿠도
rsd	세르비아 디나르
dm	독일 마크
shp	세인트 헬레나 파운드
php	필리핀 페소
cad	캐나다 달러
ssp	남수단 파운드
scr	세이셸 루피
mvr	몰디브 루피야